###################
#       #         #
#   #  E#         #
#   #####         #
#                 #
############## ####
#   S             #
###################